########
#    p #
# oo   #
#      #
########
